0,D,<,0,0,0,0,0,0,0,
0,0,^,0,0,0,0,0,0,0,
0,0,^,0,0,0,0,0,0,0,
0,r,^,0,0,0,0,0,0,0,
0,0,0,0,0,0,0,@,0,0,
0,0,0,0,0,0,0,0,0,0,
0,0,0,0,0,0,0,0,0,0,
0,0,0,0,0,0,0,0,0,0,
0,0,0,0,0,0,0,0,0,0,
0,0,0,0,0,0,0,0,0,0
